/2
####################################################
#                                                  #
#                                             #    #
#     ##############                               #
#     #            #    ##################    #    #
#     #            ######                #         #
#     ##########                         #    #    #
#                            #######     #         #
#              #             #     #     #    #    #
##########     ###############     #               #
#                                  #          #    #
#   #########         ##########   #               #
#                              #   #          #    #
#           #      #     #     #                   #
#           #      #                      ##########
#           #      ###########                     |
#                                                  |
####################################################

####################################################
|                                                  #
|                     ##############               #
#                                  #               #
#################     #########    #               #
#     ######    #             #    #               #
#  #       #    #             #    ##########      #
#  # #  #  #    #                           #      #
#  #       #    #############       ####    #      #
#  #####                               #    #      #
#                                      #    #      #
#############################          #    #      #
#                #####       ####    ###    ###    #
#                                                  #
#                     ####                         #
#                #####    ####   ####       ###    #
####################################################