####################################################
#                                                  #
#                                             #    #
#     ##############                               #
#     #            #    ##################    #    #
#     #            ######                #         #
#     ##########                         #    #    #
#                            #######     #         #
#              #             #     #     #    #    #
##########     ###############     #               #
#                                  #          #    #
#   #########         ##########   #               #
#                              #   #          #    #
#           #      #     #     #                   #
#           #      #                      ##############################################################
#           #      ###########                     ||												   #
#                                                  ||                                                  #
####################################################################     #########    #                #
													#     ######   #             #    #                #
													#  #       #   #             #    ##########       #
													#  # #  #  #   #                           #       #
													#  #       #   #############       ####    #       #
													#  #####                              #    #       #
													#                                     #    #       #
													############################          #    #       #
													#              #####        ####    ###    ###     #
													#                                                  #
													#                   ####                           #
													#              #####    ####     ####       ###    #
                                                    ####################################################